24 30
34 34 34 34 34 34 34 34 34 34 34 34 34 34 34 34 34 34 34 34 34 34 34 34
34 34 34 34 34 34 34 34 34 34 34 34 34 34 34 34 34 18 19 34 34 34 34 34
34 8 8 8 34 34 34 34 34 34 34 34 34 34 34 34 18 17 17 19 34 34 34 34
34 8 8 8 34 34 34 34 34 34 34 34 34 34 34 34 16 16 16 16 34 34 34 34
34 34 7 34 34 34 34 34 34 34 34 34 34 34 34 34 16 22 16 16 1 34 34 34
34 34 4 34 34 34 34 34 34 34 34 34 34 34 34 34 14 14 14 14 14 34 34 34
34 34 7 34 34 34 34 34 34 34 34 34 34 34 34 34 34 40 34 34 34 34 34 34
34 34 34 34 34 34 34 34 34 34 34 34 34 34 34 34 34 36 38 34 8 8 8 34
34 34 34 34 34 34 34 34 34 34 34 34 34 34 34 34 34 34 40 34 8 8 8 34
34 34 34 34 34 34 34 34 34 34 34 34 34 34 34 8 34 34 40 34 34 7 34 34
34 34 34 34 34 34 34 34 34 34 34 34 34 34 8 8 8 34 40 34 34 7 34 34
34 34 34 8 34 34 34 34 34 34 34 34 34 34 34 7 34 34 40 34 34 34 34 34
34 34 8 8 8 34 34 34 34 34 34 34 34 34 34 7 34 34 40 34 34 34 34 34
34 34 34 7 34 34 34 34 34 34 34 34 34 34 34 34 34 34 40 34 34 34 34 34
34 34 34 7 34 34 34 8 8 8 34 34 34 34 39 35 35 35 37 34 34 34 34 34
34 34 34 34 34 34 34 8 8 8 34 34 34 34 40 34 34 34 34 34 34 34 34 34
34 34 34 34 34 34 34 34 7 34 34 34 34 34 40 34 18 17 17 17 19 34 34 34
34 34 34 34 34 34 34 34 7 34 34 34 34 34 40 34 16 16 16 16 16 34 34 34
34 34 34 34 34 34 34 34 7 34 34 34 34 34 40 34 16 16 16 21 16 34 34 34
34 34 34 34 34 34 34 34 34 34 34 34 34 34 40 34 16 22 16 16 16 1 34 34
34 34 34 34 34 34 34 34 34 34 34 34 34 34 40 34 14 14 14 14 14 14 34 34
34 34 34 34 34 34 34 34 34 34 34 34 34 34 36 35 35 38 34 34 34 34 34 34
34 34 34 34 34 34 34 34 34 34 34 34 34 34 34 34 34 40 34 34 34 34 34 34
34 34 18 17 17 17 19 34 34 34 34 34 8 8 8 34 34 40 34 34 34 34 34 34
34 34 16 16 16 16 16 34 34 34 34 34 8 8 8 34 34 40 34 34 34 34 34 34
34 34 16 20 16 21 16 34 34 34 34 34 34 7 34 34 34 40 34 34 34 34 34 34
34 34 16 16 22 16 16 1 34 34 34 34 34 7 34 34 34 40 34 34 34 34 34 34
34 34 14 14 14 14 14 14 34 34 34 34 34 34 34 34 34 40 34 34 34 34 34 34
34 34 34 34 36 35 35 35 35 35 35 35 35 35 35 35 35 37 34 34 34 34 34 34
34 34 34 34 34 34 34 34 34 34 34 34 34 34 34 34 34 34 34 34 34 34 34 34