24 30
36 36 36 36 36 36 36 36 36 36 36 36 36 36 36 36 36 36 36 36 36 36 36 36
36 36 36 36 36 36 36 36 36 36 36 36 36 47 48 48 48 48 48 48 48 48 65 36
36 36 36 36 36 36 36 36 36 36 36 36 36 49 63 63 63 63 63 63 63 63 66 36
36 36 36 36 36 36 36 36 36 36 36 36 36 50 51 51 51 51 51 51 51 51 67 36
36 36 36 36 36 36 36 36 36 36 36 36 36 52 53 68 68 68 68 68 68 68 68 36
36 36 36 36 36 36 36 36 36 36 36 36 36 58 54 71 64 64 64 64 64 64 64 36
36 36 36 36 36 36 36 36 36 36 36 36 36 59 55 70 64 64 64 64 64 64 64 36
36 36 36 36 36 36 36 36 36 36 36 36 36 60 56 69 64 64 64 64 64 64 64 36
36 36 36 36 36 36 36 36 36 36 36 36 36 61 62 62 64 64 64 64 64 64 64 36
36 36 36 36 36 36 36 36 36 36 36 36 36 64 64 64 64 64 64 64 64 64 64 36
36 36 36 36 36 36 36 36 36 36 36 36 36 36 36 36 36 36 42 36 36 36 36 36
36 36 36 36 36 36 36 36 36 36 36 36 36 36 36 36 36 36 42 36 36 36 36 36
36 36 36 36 36 36 36 36 36 36 36 36 36 36 36 36 36 36 42 36 36 36 36 36
36 36 36 36 36 36 36 36 36 36 36 36 36 36 36 36 36 36 42 36 36 36 36 36
36 36 36 36 36 36 36 36 36 36 36 36 36 36 41 37 37 37 39 36 36 36 36 36
36 36 36 36 36 36 36 36 36 36 36 36 36 36 42 36 36 36 36 36 36 36 36 36
36 36 36 36 36 36 36 36 36 36 36 36 36 36 42 36 18 17 17 17 19 36 36 36
36 36 36 36 36 36 36 36 36 36 36 36 36 36 42 36 16 16 16 16 16 36 36 36
36 36 36 36 36 36 36 36 36 36 36 36 36 36 42 36 16 16 16 21 16 36 36 36
36 36 36 36 36 36 36 36 36 36 36 36 36 36 42 36 16 22 16 16 16 36 36 36
36 36 36 36 36 36 36 36 36 36 36 36 36 36 42 36 36 36 36 36 36 36 36 36
36 36 36 36 36 36 36 36 36 36 36 36 36 36 38 37 37 40 36 36 36 36 36 36
36 36 36 36 36 36 36 36 36 36 36 36 36 36 36 36 36 42 36 36 36 36 36 36
36 36 36 36 36 36 36 36 36 36 36 36 36 36 36 36 36 42 36 36 36 36 36 36
36 36 36 36 36 36 36 36 36 36 36 36 36 36 36 36 36 42 36 36 36 36 36 36
36 36 36 36 36 36 36 36 36 36 36 36 36 36 36 36 36 42 36 36 36 36 36 36
36 36 36 36 36 36 36 36 36 36 36 36 36 36 36 36 36 42 36 36 36 36 36 36
36 36 36 36 36 36 36 36 36 36 36 36 36 36 36 36 36 42 36 36 36 36 36 36
36 36 36 36 36 36 37 37 37 37 37 37 37 37 37 37 37 39 36 36 36 36 36 36
36 36 36 36 36 36 36 36 36 36 36 36 36 36 36 36 36 36 36 36 36 36 36 36