24 30
36 36 36 36 36 36 36 36 36 36 36 36 36 36 36 36 117 118 119 120 121 36 36 36
36 36 36 36 36 36 36 36 36 36 36 36 36 36 36 36 122 123 124 125 126 36 36 36
36 30 99 100 101 110 102 103 108 29 36 36 36 36 36 36 127 128 129 130 131 36 36 36
36 26 104 105 106 111 109 107 109 26 36 36 36 36 36 36 132 133 134 135 136 36 36 36
36 26 36 36 42 36 36 36 36 26 36 36 36 36 36 36 36 36 36 36 36 36 36 36
36 26 36 36 36 36 36 36 36 26 36 36 36 36 36 30 31 32 31 36 31 32 31 29
36 26 36 36 36 38 37 40 36 26 36 40 36 36 36 26 35 36 36 36 36 36 34 26
36 26 36 36 271 272 273 38 36 26 36 42 36 36 36 26 36 36 36 36 36 36 36 26
36 25 32 31 274 36 275 31 32 24 36 42 36 36 36 26 36 36 36 36 36 36 36 26
36 36 36 36 36 36 36 36 36 36 36 38 37 37 37 26 34 37 40 34 36 36 35 26
36 36 36 36 36 36 36 36 36 36 36 36 36 36 36 26 36 36 42 36 36 36 36 26
36 36 36 36 36 36 36 36 137 138 139 36 1 36 36 26 36 36 42 36 36 36 36 26
36 36 36 36 36 36 36 36 140 141 142 36 36 36 36 26 34 36 42 35 36 36 34 26
36 36 156 158 178 179 180 181 143 144 145 36 36 36 36 25 31 32 31 32 31 32 31 24
36 36 157 159 182 183 184 185 36 169 170 175 36 36 36 36 37 37 39 36 36 36 36 36
36 146 147 36 186 187 188 189 36 171 172 176 160 161 162 36 36 36 36 36 36 36 36 36
152 148 149 154 36 36 36 36 36 173 174 177 163 164 165 36 36 36 36 36 36 36 36 36
153 150 151 155 36 36 36 36 36 36 36 36 166 167 168 36 36 36 36 36 36 36 36 36
248 249 36 36 36 36 36 36 36 36 36 36 36 193 194 36 36 36 36 36 36 36 36 36
253 254 36 36 36 36 36 0 2 36 36 36 212 198 199 36 36 36 36 36 36 36 36 36
258 259 260 36 36 36 36 7 8 36 36 36 213 203 204 36 36 36 36 36 36 36 36 36
36 250 251 36 36 36 36 36 36 36 36 36 214 208 209 36 37 40 36 36 36 36 36 36
36 255 256 252 36 36 36 236 237 36 36 36 190 191 192 36 36 42 36 36 36 36 36 36
36 261 262 257 36 36 36 36 36 36 36 36 195 196 197 36 36 36 36 36 36 36 36 36
36 36 263 264 267 36 36 233 234 235 36 36 200 201 202 36 36 36 36 36 36 36 36 36
36 36 265 266 268 241 242 238 239 240 241 242 205 206 207 36 36 36 36 36 36 36 36 36
36 36 36 269 270 246 247 243 244 245 246 247 210 211 36 36 36 36 36 36 36 36 36 36
36 36 36 42 36 36 36 36 36 36 36 36 36 36 36 36 36 42 36 36 36 36 36 36
36 36 36 38 37 37 37 37 37 37 37 37 37 37 37 37 37 39 36 36 36 36 36 36
36 36 36 36 36 36 36 36 36 36 36 36 36 36 36 36 36 36 36 36 36 36 36 36