24 30
36 36 36 36 36 36 36 36 36 36 36 36 36 36 36 36 36 36 36 36 36 36 36 36
36 36 36 36 36 36 36 36 36 36 36 36 36 36 36 36 36 18 19 36 36 36 36 36
36 8 8 8 36 36 36 36 36 36 36 36 36 36 36 36 18 17 17 19 36 36 36 36
36 8 8 8 36 36 36 36 36 36 36 36 36 36 36 36 16 16 16 16 36 36 36 36
36 36 7 36 36 36 36 36 36 36 36 36 36 36 36 36 16 22 16 16 1 36 36 36
36 36 4 36 36 36 36 36 36 36 36 36 36 36 36 36 14 14 14 14 14 36 36 36
36 36 7 36 36 36 36 36 36 36 36 36 36 36 36 36 36 42 36 36 36 36 36 36
36 36 36 36 36 36 36 36 36 36 36 36 36 36 36 36 36 38 40 36 8 8 8 36
36 36 36 36 36 36 36 36 36 36 36 36 36 36 36 36 36 36 42 36 8 8 8 36
36 36 36 36 36 36 36 36 36 36 36 36 36 36 36 8 36 36 42 36 36 7 36 36
36 36 36 36 36 36 36 36 36 36 36 36 36 36 8 8 8 36 42 36 36 7 36 36
36 36 36 8 36 36 36 36 36 36 36 36 36 36 36 7 36 36 42 36 36 36 36 36
36 36 8 8 8 36 36 36 36 36 36 36 36 36 36 7 36 36 42 36 36 36 36 36
36 36 36 7 36 36 36 36 36 36 36 36 36 36 36 36 36 36 42 36 36 36 36 36
36 36 36 7 36 36 36 8 8 8 36 36 36 36 41 37 37 37 39 36 36 36 36 36
36 36 36 36 36 36 36 8 8 8 36 36 36 36 42 36 36 36 36 36 36 36 36 36
36 36 36 36 36 36 36 36 7 36 36 36 36 36 42 36 18 17 17 17 19 36 36 36
36 36 36 36 36 36 36 36 7 36 36 36 36 36 42 36 16 16 16 16 16 36 36 36
36 36 36 36 36 36 36 36 7 36 36 36 36 36 42 36 16 16 16 21 16 36 36 36
36 36 36 36 36 36 36 36 36 36 36 36 36 36 42 36 16 22 16 16 16 1 36 36
36 36 36 36 36 36 36 36 36 36 36 36 36 36 42 36 14 14 14 14 14 14 36 36
36 36 36 36 36 36 36 36 36 36 36 36 36 36 38 37 37 40 36 36 36 36 36 36
36 36 36 36 36 36 36 36 36 36 36 36 36 36 36 36 36 42 36 36 36 36 36 36
36 36 18 17 17 17 19 36 36 36 36 36 36 8 8 36 36 42 36 36 36 36 36 36
36 36 16 16 16 16 16 36 36 36 36 36 8 8 8 36 36 42 36 36 36 36 36 36
36 36 16 20 16 21 16 36 36 36 36 36 36 7 36 36 36 42 36 36 36 36 36 36
36 36 16 16 22 16 16 1 36 36 36 36 36 7 36 36 36 42 36 36 36 36 36 36
36 36 14 14 14 14 14 14 36 36 36 36 36 36 36 36 36 42 36 36 36 36 36 36
36 36 36 36 38 37 37 37 37 37 37 37 37 37 37 37 37 39 36 36 36 36 36 36
36 36 36 36 36 36 36 36 36 36 36 36 36 36 36 36 36 36 36 36 36 36 36 36