34 30
36 36 36 36 36 36 36 36 36 36 36 36 36 36 36 36 36 36 30 31 32 31 32 31 32 31 32 31 32 31 32 31 29 36
36 36 117 118 119 120 121 36 36 36 36 36 36 36 36 36 36 36 26 36 36 36 36 36 36 36 36 36 36 36 36 36 26 36
36 36 122 123 124 125 126 36 36 36 36 36 36 36 36 36 36 36 26 36 36 36 99 100 101 110 102 103 108 36 36 36 26 36
36 36 127 128 129 130 131 36 36 36 36 36 36 36 36 36 36 36 26 36 36 36 104 105 106 111 106 107 109 36 36 36 26 36
36 36 132 133 134 135 136 36 36 36 36 36 36 36 36 36 36 36 26 36 36 36 36 36 36 36 36 36 36 36 36 36 26 36
36 36 36 36 36 36 36 36 36 36 36 36 36 36 36 36 36 36 26 36 36 36 36 36 36 36 36 36 36 36 36 36 26 36
36 30 31 32 31 36 31 32 31 32 31 29 36 36 36 36 36 36 26 36 36 36 36 36 36 36 36 36 36 36 36 36 26 36
36 26 36 35 36 36 36 36 36 36 36 26 36 36 36 36 36 36 26 36 36 36 36 36 306 307 308 36 36 36 36 36 26 36
36 26 36 301 302 36 36 36 36 35 36 26 36 36 36 36 36 36 25 31 32 31 32 31 309 36 310 31 32 31 32 31 24 36
36 26 34 36 36 36 36 36 36 36 304 26 36 36 36 36 36 36 36 36 36 36 36 36 36 36 36 36 36 36 36 36 36 36
36 26 36 35 36 36 36 36 36 34 36 26 36 36 36 36 36 36 36 36 36 36 36 36 36 36 36 36 36 36 36 36 36 36
36 26 298 36 36 34 36 36 36 36 36 26 36 36 36 36 36 36 36 36 36 36 36 36 36 36 36 36 36 36 36 36 36 36
36 26 303 36 36 36 36 36 36 36 36 26 36 36 36 36 36 36 36 137 138 139 182 183 184 185 36 36 36 36 36 36 36 36
36 26 36 36 36 36 36 36 35 36 36 26 36 36 36 36 36 36 36 140 141 142 186 187 188 189 169 170 175 36 36 36 36 36
36 26 34 36 36 36 36 36 36 36 36 26 36 36 36 36 36 156 158 143 144 145 190 191 192 193 171 172 176 160 161 162 36 36
36 26 36 36 35 36 36 34 36 36 36 26 36 36 36 146 147 157 159 36 36 36 36 36 36 36 173 174 177 163 164 165 36 36
36 26 36 36 36 36 36 36 36 36 36 26 36 36 152 148 149 154 36 36 36 36 36 36 36 36 36 36 36 166 167 168 36 36
36 26 299 300 36 36 36 36 36 36 35 26 36 36 153 150 151 155 36 36 36 36 36 36 36 36 36 36 36 36 36 36 198 199
36 26 36 36 36 36 36 36 34 36 36 26 36 36 273 274 36 36 36 36 36 36 36 0 2 36 36 36 36 36 36 235 203 204
36 26 35 36 34 36 36 36 36 296 297 26 36 36 278 279 36 36 36 36 36 36 36 7 8 36 36 36 36 36 36 236 208 209
36 26 36 36 36 36 36 36 36 36 36 26 36 36 283 284 285 36 36 36 36 36 36 36 36 36 36 36 36 36 36 237 213 214
36 26 34 304 305 36 36 35 36 36 36 26 36 36 36 275 276 36 36 36 36 36 36 36 36 36 36 36 36 36 36 195 196 197
36 25 31 32 31 32 31 32 31 32 31 24 36 36 36 280 281 277 36 36 36 36 36 36 36 36 36 36 36 36 36 200 201 202
36 36 36 36 36 36 36 36 36 36 36 36 36 36 36 286 287 282 36 36 36 36 36 36 36 269 36 36 36 36 36 205 206 207
36 36 36 36 36 36 36 36 36 36 36 36 36 36 36 36 288 289 292 36 239 240 36 36 270 271 272 36 36 239 240 210 211 212
36 36 36 36 1 36 36 36 36 36 36 36 36 36 36 36 290 291 293 243 244 245 258 259 260 261 262 247 243 244 245 233 234 36
36 36 36 36 36 36 36 36 36 36 36 36 36 36 36 36 36 294 295 248 249 250 268 36 36 36 36 257 248 249 250 251 36 36
36 36 36 36 36 36 36 36 36 36 36 36 36 36 36 36 36 36 36 253 254 255 263 264 265 266 267 252 253 254 255 256 36 36
36 36 36 36 36 36 36 36 36 36 36 36 36 36 36 36 36 36 36 36 36 36 36 36 36 36 36 36 36 36 36 36 36 36
36 36 36 36 36 36 36 36 36 36 36 36 36 36 36 36 36 36 36 36 36 36 36 36 36 36 36 36 36 36 36 36 36 36