24 30
36 36 36 36 36 36 36 36 36 36 36 36 36 36 36 36 36 36 36 36 36 36 36 36
36 36 36 36 36 36 36 36 36 36 36 36 36 36 36 36 36 36 36 36 36 36 36 36
36 99 100 102 110 102 103 108 36 36 36 36 36 36 36 36 36 36 36 36 36 36 36 36
36 104 105 106 111 106 107 109 36 36 36 36 36 36 36 36 36 36 36 36 36 36 36 36
36 36 36 36 42 36 36 36 36 36 36 36 36 36 36 36 36 36 36 36 36 36 36 36
36 36 36 36 42 36 36 36 36 36 36 36 36 36 36 36 36 36 36 36 36 36 36 36
36 36 36 36 42 36 36 42 36 36 36 42 36 36 36 36 36 36 36 36 36 36 36 36
36 36 36 36 42 36 36 38 37 40 36 42 36 36 36 36 36 36 36 36 36 36 36 36
36 36 36 36 42 36 36 36 36 42 36 42 36 36 36 36 36 36 36 36 36 36 36 36
36 36 36 117 128 119 36 36 36 42 36 38 37 37 37 37 37 37 40 36 36 36 36 36
36 36 36 120 42 121 36 36 36 42 36 36 36 36 36 36 36 36 42 36 36 36 36 36
36 36 36 36 36 36 36 36 36 42 36 36 1 36 36 36 36 36 42 36 36 36 36 36
36 36 36 36 36 36 36 36 36 42 36 36 36 36 36 36 36 36 42 36 36 36 36 36
36 36 36 36 36 36 36 36 36 42 36 36 36 36 36 36 36 36 42 36 36 36 36 36
36 36 36 36 36 36 36 36 36 42 36 36 36 36 41 37 37 37 39 36 36 36 36 36
36 36 36 36 36 36 36 36 36 42 36 36 36 36 42 36 36 36 36 12 12 12 36 36
36 36 36 36 0 2 36 36 36 42 36 36 36 36 42 36 117 118 119 120 121 12 12 36
36 36 36 36 7 8 36 36 36 42 36 36 36 36 42 36 122 123 124 125 126 12 12 36
36 36 36 36 36 36 36 36 36 42 36 36 36 36 42 36 127 128 129 130 131 12 12 36
36 36 36 41 37 37 37 37 37 39 36 36 36 36 42 36 132 133 134 135 136 36 36 36
36 36 36 42 36 36 36 36 36 36 36 36 36 36 42 36 36 36 36 36 36 36 36 36
36 36 36 42 36 36 36 36 36 36 36 36 36 36 38 37 37 40 36 36 36 36 36 36
36 36 36 42 36 36 36 36 36 36 36 36 36 36 36 36 36 42 36 36 36 36 36 36
36 36 36 42 36 36 36 36 36 36 36 36 36 36 36 36 36 42 36 36 36 36 36 36
36 36 36 42 36 36 36 36 36 36 36 36 36 36 36 36 36 42 36 36 36 36 36 36
36 36 36 42 36 36 36 36 36 36 36 36 36 36 36 36 36 42 36 36 36 36 36 36
36 36 36 42 36 36 36 36 36 36 36 36 36 36 36 36 36 42 36 36 36 36 36 36
36 36 36 42 36 36 36 36 36 36 36 36 36 36 36 36 36 42 36 36 36 36 36 36
36 36 36 38 37 37 37 37 37 37 37 37 37 37 37 37 37 39 36 36 36 36 36 36
36 36 36 36 36 36 36 36 36 36 36 36 36 36 36 36 36 36 36 36 36 36 36 36