17 12
30 31 32 31 32 31 32 31 32 31 29 36 36 36 36 36 36
26 35 36 36 36 34 36 35 36 35 26 36 36 36 36 36 36
26 36 36 36 36 36 36 36 36 36 26 36 36 36 36 36 36
26 34 36 34 36 36 36 34 36 36 26 36 36 36 36 36 36
26 36 36 36 36 35 36 36 36 36 26 36 117 118 119 120 121
26 35 36 36 36 36 36 36 36 35 26 36 122 123 124 125 126
26 36 36 34 36 35 36 34 36 36 23 36 127 128 129 130 131
26 34 36 36 36 36 36 36 36 36 36 36 132 133 134 135 136
26 36 36 36 36 35 36 36 36 36 28 36 36 36 36 36 36
26 36 36 34 36 36 36 35 36 36 26 36 36 36 36 36 36
26 35 36 36 36 34 36 36 36 34 26 36 36 36 36 36 36
25 31 32 31 32 31 32 31 32 31 24 36 36 36 36 36 36