17 12
12 12 35 12 34 12 12 12 12 12 12 12 12 12 12 12 12
12 12 12 12 12 12 12 12 12 12 35 12 12 12 34 12 12
12 12 12 12 12 12 12 34 12 12 12 12 12 12 12 12 12
12 34 12 12 12 12 12 12 12 12 12 12 12 12 12 35 12
12 12 12 12 12 35 12 12 12 12 35 12 12 12 12 12 12
12 35 12 12 12 12 12 12 12 12 12 12 12 34 12 12 12
12 12 12 12 12 12 12 34 12 12 35 12 12 12 12 12 12
12 12 36 12 12 35 12 12 12 12 12 12 12 12 12 12 12
12 36 34 12 12 12 12 12 12 12 12 35 12 12 12 12 12
12 12 12 12 12 12 12 12 12 12 12 12 12 12 34 12 12
36 35 12 12 34 12 12 12 12 35 12 12 12 12 12 12 12
12 12 12 12 12 12 12 12 12 12 12 12 12 12 12 12 12