17 12
12 12 12 12 12 12 12 12 12 12 12 12 12 12 12 12 12
17 19 12 12 12 12 12 12 12 12 12 12 12 12 12 12 12
16 16 12 12 12 12 12 12 12 10 10 10 12 12 12 12 12
16 16 12 12 12 12 12 12 12 10 10 10 12 12 12 12 12
16 16 14 12 12 12 12 12 12 12 12 12 12 12 12 12 12
14 14 14 12 12 12 12 12 12 12 12 12 12 12 12 12 12
12 12 12 12 12 12 12 12 12 12 12 17 17 17 19 12 12
12 12 12 12 12 12 12 12 12 12 16 16 16 16 16 12 12
12 12 12 12 12 9 9 9 12 12 16 16 16 21 16 12 12
12 12 12 12 12 9 9 9 12 14 16 22 16 16 16 12 12
12 12 12 12 12 12 12 12 12 14 14 14 14 14 14 14 12
12 12 12 12 12 12 12 12 12 12 12 12 12 12 12 12 12